11111111111111111111111111111
121222222222222222222222221f1
12122222222222222222222222121
12122222222222222222222222121
12122222222222222222222222121
12113331122222223332222222121
12224222222222222232222222121
11111111122222223332222222121
12222222222222222222222222221
12222222222222222222222222221
12222222222222222222222222221
12222222222222222222222222221
12222222222222222222232222221
12222233222222222222222222221
12222332222222222222222222221
12222222222222222222222222221
12222222222222222222222222221
12222233222233322222222222221
12222222222224222223322222221
12222222222240422222222222221
12222222222234222222222222221
12222222222233322222222222221
12222222222222222222222222221
12222232222222222422000222221
12222222222222222222000222221
14000000022222222222000222221
10000500022222222222000222221
12222222222222222222040222221
11111111111111111111111111111