11111111111111111111111111111
12222222222222222222222222221
12333222222222222222222222221
12222322222222222222222222221
12222222222222223432222222221
12222222222222222322222222221
12222232222222222222222211221
12222222222222222222222233221
12222222222222222222222344321
12222222222222222222223222231
13222222222222222222232222221
12322222222222222222232222221
12231111111111222222222321111
12222244422222222222222222221
12222222222222222222222222221
12222222222222222222222222221
12222332233222222222222222221
12222222222222222222222222221
12222222232222222211122222221
12222222343212111122222222221
12222222332212222122222222221
12222222222211112122222222221
12222222222222212122222222221
12242122222222212112222222221
12222222222222212221221112221
12222222222222221121222322221
12222222222222222122111f12221
12222222222222222222222222221
11111111111111111111111111111