11111111111111111111111111111
12323222222222223343322222141
12232222222222222333222222101
12222222222000222222222222101
12222222222050222222222222101
12222222222000222222222222151
12222222222222222222222222101
12222222222222222222222222221
12222222222222222222222222221
12222322223222222222222222221
12222222222222222222222222221
12222000000222222222222222221
12244521125222222222222222221
11111111111111111111111111121
13222222222222222222222222121
14322222222222222222222221221
13222222222222222222222212221
12222222200000222222222122221
12222222200500222222223222221
12222222200400222222222322221
12222222200500222222222232221
12222222200000222222222223221
12222222222222222222222222321
11111111222222222222222222221
1f000051222222222222222222221
10000001222222222222222222221
10040001333222222222111111111
10000002222222222222000040051
11111111111111111111111111111