11111111111111111111111111111
12222222222234143322222222221
12222222222223132322222222221
12222222222223133322222222221
12222222222222122222222222221
12222222222222122222222222221
12222222222222122222222222221
12222222222222122222222222221
12222222222222122222222222221
12222222222222122222222222221
12222222222222122222222333321
12222222222233122222222344321
12222222222222422222222333321
12222222222211122222222222221
12222222222222122222222222221
12222222222222122222222222221
12222222222222122222222222221
12222222222222122222222222221
12222222222222122222222222221
12222222222222122222222222221
12222222222222122222222222221
12242222222222122222222222221
12222222222222122222222222221
12222222222222122222222000001
12222222232222122222222000001
12222222221222122222222005001
12222222234122122222222000001
122222222212221422222220000f1
11111111111111111111111111111