11111111111111111111111111111
121f2222222222222222222222221
12122222222222222222222222221
12111222222222222222222222221
12223000022222222222222222221
11111222222222222222222222221
12222222222222222222222222221
12222222222222222222222222221
12222222222222222222222222221
12222222222222222222222222221
12222222222222222222222222221
12222222222222222222222222221
12222222222222222222222222221
12222111111122222222222222221
12222350000322222222222222221
12222300400322222222222222221
12222304440322222222222222221
12222300400322222222222222221
12222300000322222222222222221
12222333333322222222222222221
12222222222222222222222222331
11122222222222222222222222221
14122222222222222222232332321
14122222222222222223223232321
12122222222222222222223243221
12111112222222222223223223221
10000032222222222223223322321
10111112222222223222232232221
11111111111111111111111111111